Unnamed: 0,Year,Week,cases,incidence_per_100000,CCC,epi_stages
0,1930,1,178,3.12,178,Initial
1,1930,2,442,7.74,620,Initial
2,1930,3,490,8.58,1110,Pre-peak
3,1930,4,628,11,1738,Pre-peak
4,1930,5,864,15.13,2602,Pre-peak
5,1930,6,943,16.51,3545,Pre-peak
6,1930,7,954,16.7,4499,Pre-peak
7,1930,8,1151,20.15,5650,Pre-peak
8,1930,9,1433,25.09,7083,Peak
9,1930,10,1514,26.51,8597,Peak
10,1930,11,1805,31.61,10402,Peak
11,1930,12,1901,33.29,12303,Peak
12,1930,13,2173,38.05,14476,Peak
13,1930,14,2216,38.8,16692,Peak
14,1930,15,2524,44.2,19216,Peak
15,1930,16,1766,30.92,20982,Peak
16,1930,17,2399,42.01,23381,Peak
17,1930,18,2053,35.95,25434,Peak
18,1930,19,2114,37.02,27548,Peak
19,1930,20,2033,35.6,29581,Peak
20,1930,21,2221,38.89,31802,Peak
21,1930,22,1977,34.62,33779,Peak
22,1930,23,1934,33.86,35713,Peak
23,1930,24,1470,25.74,37183,Peak
24,1930,25,1186,20.77,38369,Post_peak
25,1930,26,924,16.18,39293,Post_peak
26,1930,27,665,11.64,39958,Post_peak
27,1930,28,552,9.67,40510,Post_peak
28,1930,29,326,5.71,40836,Post_peak
29,1930,30,181,3.17,41017,Receding
30,1930,31,158,2.77,41175,Receding
31,1930,32,84,1.47,41259,Receding
32,1930,33,85,1.49,41344,Receding
33,1930,34,59,1.03,41403,Receding
34,1930,35,44,0.77,41447,Receding
35,1930,36,40,0.7,41487,Receding
36,1930,37,47,0.82,41534,Receding
37,1930,38,41,0.72,41575,Receding
38,1930,39,56,0.98,41631,Receding
39,1930,40,67,1.17,41698,Receding
40,1930,41,62,1.09,41760,Receding
41,1930,42,123,2.15,41883,Receding
42,1930,43,86,1.51,41969,Receding
43,1930,44,131,2.29,42100,Receding
44,1930,45,109,1.91,42209,Receding
45,1930,46,94,1.65,42303,Receding
46,1930,47,117,2.05,42420,Receding
47,1930,48,188,3.29,42608,Receding
48,1930,49,255,4.47,42863,Post_peak
49,1930,50,221,3.87,43084,Receding
50,1930,51,223,3.9,43307,Receding
51,1930,52,109,1.91,43416,Receding
52,1931,1,272,4.67,272,Initial
53,1931,2,363,6.23,635,Initial
54,1931,3,546,9.38,1181,Pre-peak
55,1931,4,509,8.74,1690,Pre-peak
56,1931,5,676,11.61,2366,Pre-peak
57,1931,6,809,13.89,3175,Pre-peak
58,1931,7,996,17.1,4171,Peak
59,1931,8,939,16.12,5110,Peak
60,1931,9,1205,20.69,6315,Peak
61,1931,10,1256,21.57,7571,Peak
62,1931,11,1378,23.66,8949,Peak
63,1931,12,1796,30.84,10745,Peak
64,1931,13,1273,21.86,12018,Peak
65,1931,14,1532,26.3,13550,Peak
66,1931,15,1461,25.09,15011,Peak
67,1931,16,1558,26.75,16569,Peak
68,1931,17,1297,22.27,17866,Peak
69,1931,18,1309,22.48,19175,Peak
70,1931,19,1174,20.16,20349,Peak
71,1931,20,1110,19.06,21459,Peak
72,1931,21,899,15.44,22358,Peak
73,1931,22,935,16.05,23293,Peak
74,1931,23,730,12.53,24023,Post_peak
75,1931,24,502,8.62,24525,Post_peak
76,1931,25,393,6.75,24918,Post_peak
77,1931,26,269,4.62,25187,Post_peak
78,1931,27,232,3.98,25419,Post_peak
79,1931,28,159,2.73,25578,Receding
80,1931,29,148,2.54,25726,Receding
81,1931,30,90,1.55,25816,Receding
82,1931,31,60,1.03,25876,Receding
83,1931,32,53,0.91,25929,Receding
84,1931,33,29,0.5,25958,Receding
85,1931,34,49,0.84,26007,Receding
86,1931,35,57,0.98,26064,Receding
87,1931,36,39,0.67,26103,Receding
88,1931,37,73,1.25,26176,Receding
89,1931,38,37,0.64,26213,Receding
90,1931,39,54,0.93,26267,Receding
91,1931,40,71,1.22,26338,Receding
92,1931,41,72,1.24,26410,Receding
93,1931,42,68,1.17,26478,Receding
94,1931,43,108,1.85,26586,Receding
95,1931,44,168,2.88,26754,Receding
96,1931,45,104,1.79,26858,Receding
97,1931,46,181,3.11,27039,Post_peak
98,1931,47,116,1.99,27155,Receding
99,1931,48,187,3.21,27342,Post_peak
100,1931,49,146,2.51,27488,Receding
101,1931,50,99,1.7,27587,Receding
102,1931,51,43,0.74,27630,Receding
103,1931,52,177,3.04,27807,Receding
104,1933,1,98,1.64,98,Initial
105,1933,2,108,1.81,206,Initial
106,1933,3,182,3.05,388,Initial
107,1933,4,233,3.91,621,Initial
108,1933,5,312,5.23,933,Initial
109,1933,6,363,6.09,1296,Pre-peak
110,1933,7,449,7.53,1745,Pre-peak
111,1933,8,719,12.06,2464,Peak
112,1933,9,911,15.28,3375,Peak
113,1933,10,985,16.52,4360,Peak
114,1933,11,1146,19.22,5506,Peak
115,1933,12,1378,23.11,6884,Peak
116,1933,13,1272,21.33,8156,Peak
117,1933,14,1219,20.44,9375,Peak
118,1933,15,1220,20.46,10595,Peak
119,1933,16,1229,20.61,11824,Peak
120,1933,17,1315,22.05,13139,Peak
121,1933,18,1329,22.29,14468,Peak
122,1933,19,1388,23.28,15856,Peak
123,1933,20,1221,20.48,17077,Peak
124,1933,21,1255,21.05,18332,Peak
125,1933,22,1128,18.92,19460,Peak
126,1933,23,1274,21.37,20734,Peak
127,1933,24,771,12.93,21505,Peak
128,1933,25,558,9.36,22063,Post_peak
129,1933,26,534,8.96,22597,Post_peak
130,1933,27,343,5.75,22940,Post_peak
131,1933,28,347,5.82,23287,Post_peak
132,1933,29,177,2.97,23464,Post_peak
133,1933,30,169,2.83,23633,Post_peak
134,1933,31,106,1.78,23739,Receding
135,1933,32,97,1.63,23836,Receding
136,1933,33,48,0.8,23884,Receding
137,1933,34,70,1.17,23954,Receding
138,1933,35,43,0.72,23997,Receding
139,1933,36,40,0.67,24037,Receding
140,1933,37,74,1.24,24111,Receding
141,1933,38,119,2,24230,Receding
142,1933,39,71,1.19,24301,Receding
143,1933,40,134,2.25,24435,Receding
144,1933,41,108,1.81,24543,Receding
145,1933,42,208,3.49,24751,Post_peak
146,1933,43,193,3.24,24944,Post_peak
147,1933,44,169,2.83,25113,Post_peak
148,1933,45,139,2.33,25252,Post_peak
149,1933,46,172,2.88,25424,Post_peak
150,1933,47,126,2.11,25550,Receding
151,1933,48,162,2.72,25712,Post_peak
152,1933,49,167,2.8,25879,Post_peak
153,1933,50,137,2.3,26016,Receding
154,1933,51,209,3.5,26225,Post_peak
155,1933,52,326,5.47,26551,Post_peak
156,1934,1,390,6.44,390,Initial
157,1934,2,635,10.48,1025,Pre-peak
158,1934,3,339,5.59,1364,Pre-peak
159,1934,4,763,12.59,2127,Pre-peak
160,1934,5,1129,18.63,3256,Peak
161,1934,6,1187,19.59,4443,Peak
162,1934,7,1340,22.11,5783,Peak
163,1934,8,1154,19.04,6937,Peak
164,1934,9,1570,25.91,8507,Peak
165,1934,10,1491,24.6,9998,Peak
166,1934,11,1363,22.49,11361,Peak
167,1934,12,1158,19.11,12519,Peak
168,1934,13,798,13.17,13317,Peak
169,1934,14,828,13.66,14145,Peak
170,1934,15,688,11.35,14833,Post_peak
171,1934,16,942,15.54,15775,Peak
172,1934,17,751,12.39,16526,Post_peak
173,1934,18,930,15.35,17456,Peak
174,1934,19,731,12.06,18187,Post_peak
175,1934,20,746,12.31,18933,Post_peak
176,1934,21,1119,18.47,20052,Peak
177,1934,22,448,7.39,20500,Post_peak
178,1934,23,879,14.5,21379,Peak
179,1934,24,942,15.54,22321,Peak
180,1934,25,490,8.09,22811,Post_peak
181,1934,26,515,8.5,23326,Post_peak
182,1934,27,209,3.45,23535,Post_peak
183,1934,28,243,4.01,23778,Post_peak
184,1934,29,140,2.31,23918,Receding
185,1934,30,55,0.91,23973,Receding
186,1934,31,86,1.42,24059,Receding
187,1934,32,65,1.07,24124,Receding
188,1934,33,45,0.74,24169,Receding
189,1934,34,35,0.58,24204,Receding
190,1934,35,16,0.26,24220,Receding
191,1934,36,22,0.36,24242,Receding
192,1934,37,38,0.63,24280,Receding
193,1934,38,44,0.73,24324,Receding
194,1934,39,47,0.78,24371,Receding
195,1934,40,55,0.91,24426,Receding
196,1934,41,36,0.59,24462,Receding
197,1934,42,144,2.38,24606,Receding
198,1934,43,156,2.57,24762,Receding
199,1934,44,20,0.33,24782,Receding
200,1934,45,152,2.51,24934,Receding
201,1934,46,50,0.83,24984,Receding
202,1934,47,148,2.44,25132,Receding
203,1934,48,111,1.83,25243,Receding
204,1934,49,124,2.05,25367,Receding
205,1934,50,171,2.82,25538,Post_peak
206,1934,51,46,0.76,25584,Receding
207,1934,52,66,1.09,25650,Receding
208,1935,1,85,1.38,85,Initial
209,1935,2,144,2.33,229,Initial
210,1935,3,148,2.4,377,Initial
211,1935,4,239,3.87,616,Initial
212,1935,5,267,4.32,883,Initial
213,1935,6,282,4.57,1165,Pre-peak
214,1935,7,530,8.58,1695,Pre-peak
215,1935,8,601,9.73,2296,Pre-peak
216,1935,9,564,9.13,2860,Pre-peak
217,1935,10,598,9.68,3458,Pre-peak
218,1935,11,885,14.33,4343,Peak
219,1935,12,984,15.94,5327,Peak
220,1935,13,1046,16.94,6373,Peak
221,1935,14,1313,21.26,7686,Peak
222,1935,15,1645,26.64,9331,Peak
223,1935,16,1413,22.88,10744,Peak
224,1935,17,1606,26.01,12350,Peak
225,1935,18,1595,25.83,13945,Peak
226,1935,19,1682,27.24,15627,Peak
227,1935,20,1714,27.76,17341,Peak
228,1935,21,1612,26.11,18953,Peak
229,1935,22,1281,20.74,20234,Peak
230,1935,23,1451,23.5,21685,Peak
231,1935,24,1097,17.77,22782,Peak
232,1935,25,928,15.03,23710,Peak
233,1935,26,665,10.77,24375,Post_peak
234,1935,27,477,7.72,24852,Post_peak
235,1935,28,418,6.77,25270,Post_peak
236,1935,29,294,4.76,25564,Post_peak
237,1935,30,223,3.61,25787,Post_peak
238,1935,31,148,2.4,25935,Receding
239,1935,32,99,1.6,26034,Receding
240,1935,33,100,1.62,26134,Receding
241,1935,34,87,1.41,26221,Receding
242,1935,35,82,1.33,26303,Receding
243,1935,36,73,1.18,26376,Receding
244,1935,37,60,0.97,26436,Receding
245,1935,38,77,1.25,26513,Receding
246,1935,39,87,1.41,26600,Receding
247,1935,40,71,1.15,26671,Receding
248,1935,41,123,1.99,26794,Receding
249,1935,42,116,1.88,26910,Receding
250,1935,43,137,2.22,27047,Receding
251,1935,44,114,1.85,27161,Receding
252,1935,45,154,2.49,27315,Receding
253,1935,46,140,2.27,27455,Receding
254,1935,47,204,3.3,27659,Post_peak
255,1935,48,127,2.06,27786,Receding
256,1935,49,241,3.9,28027,Post_peak
257,1935,50,253,4.1,28280,Post_peak
258,1935,51,302,4.89,28582,Post_peak
259,1935,52,217,3.51,28799,Post_peak
260,1936,1,422,6.66,422,Initial
261,1936,2,733,11.56,1155,Pre-peak
262,1936,3,933,14.71,2088,Pre-peak
263,1936,4,987,15.57,3075,Pre-peak
264,1936,5,1228,19.37,4303,Pre-peak
265,1936,6,1336,21.07,5639,Pre-peak
266,1936,7,1529,24.11,7168,Peak
267,1936,8,1814,28.61,8982,Peak
268,1936,9,1890,29.81,10872,Peak
269,1936,10,2729,43.04,13601,Peak
270,1936,11,2676,42.2,16277,Peak
271,1936,12,1985,31.3,18262,Peak
272,1936,13,2597,40.96,20859,Peak
273,1936,14,2640,41.63,23499,Peak
274,1936,15,2342,36.93,25841,Peak
275,1936,16,2692,42.45,28533,Peak
276,1936,17,2841,44.8,31374,Peak
277,1936,18,2217,34.96,33591,Peak
278,1936,19,1914,30.18,35505,Peak
279,1936,20,1908,30.09,37413,Peak
280,1936,21,2096,33.05,39509,Peak
281,1936,22,1567,24.71,41076,Peak
282,1936,23,1603,25.28,42679,Peak
283,1936,24,1135,17.9,43814,Post_peak
284,1936,25,1107,17.46,44921,Post_peak
285,1936,26,1201,18.94,46122,Post_peak
286,1936,27,1467,23.14,47589,Peak
287,1936,28,323,5.09,47912,Post_peak
288,1936,29,296,4.67,48208,Post_peak
289,1936,30,155,2.44,48363,Receding
290,1936,31,91,1.44,48454,Receding
291,1936,32,67,1.06,48521,Receding
292,1936,33,55,0.87,48576,Receding
293,1936,34,49,0.77,48625,Receding
294,1936,35,43,0.68,48668,Receding
295,1936,36,18,0.28,48686,Receding
296,1936,37,18,0.28,48704,Receding
297,1936,38,40,0.63,48744,Receding
298,1936,39,32,0.5,48776,Receding
299,1936,40,30,0.47,48806,Receding
300,1936,41,17,0.27,48823,Receding
301,1936,42,16,0.25,48839,Receding
302,1936,43,46,0.73,48885,Receding
303,1936,44,24,0.38,48909,Receding
304,1936,45,22,0.35,48931,Receding
305,1936,46,19,0.3,48950,Receding
306,1936,47,34,0.54,48984,Receding
307,1936,48,26,0.41,49010,Receding
308,1936,49,27,0.43,49037,Receding
309,1936,50,13,0.21,49050,Receding
310,1938,1,43,0.65,43,Initial
311,1938,2,116,1.74,159,Initial
312,1938,3,110,1.65,269,Initial
313,1938,4,174,2.61,443,Initial
314,1938,5,311,4.67,754,Initial
315,1938,6,185,2.78,939,Initial
316,1938,7,205,3.08,1144,Pre-peak
317,1938,8,252,3.79,1396,Pre-peak
318,1938,9,398,5.98,1794,Pre-peak
319,1938,10,348,5.23,2142,Pre-peak
320,1938,11,609,9.15,2751,Peak
321,1938,12,541,8.13,3292,Peak
322,1938,13,686,10.31,3978,Peak
323,1938,14,616,9.25,4594,Peak
324,1938,15,541,8.13,5135,Peak
325,1938,16,685,10.29,5820,Peak
326,1938,17,812,12.2,6632,Peak
327,1938,18,686,10.31,7318,Peak
328,1938,19,640,9.62,7958,Peak
329,1938,20,978,14.69,8936,Peak
330,1938,21,564,8.47,9500,Peak
331,1938,22,624,9.38,10124,Peak
332,1938,23,871,13.09,10995,Peak
333,1938,24,1017,15.28,12012,Peak
334,1938,25,433,6.51,12445,Post_peak
335,1938,26,97,1.46,12542,Receding
336,1938,27,394,5.92,12936,Post_peak
337,1938,28,223,3.34,13159,Post_peak
338,1938,29,162,2.43,13321,Post_peak
339,1938,30,156,2.34,13477,Post_peak
340,1938,31,105,1.57,13582,Post_peak
341,1938,32,78,1.17,13660,Receding
342,1938,33,84,1.25,13744,Receding
343,1938,34,84,1.26,13828,Receding
344,1938,35,49,0.74,13877,Receding
345,1938,36,49,0.73,13926,Receding
346,1938,37,145,2.18,14071,Post_peak
347,1938,38,167,2.51,14238,Post_peak
348,1938,39,130,1.95,14368,Post_peak
349,1938,40,93,1.4,14461,Receding
350,1938,41,173,2.6,14634,Post_peak
351,1938,42,122,1.83,14756,Post_peak
352,1938,43,158,2.37,14914,Post_peak
353,1938,44,275,4.13,15189,Post_peak
354,1938,45,209,3.14,15398,Post_peak
355,1938,46,248,3.73,15646,Post_peak
356,1938,47,203,3.05,15849,Post_peak
357,1938,48,298,4.47,16147,Post_peak
358,1938,49,450,6.76,16597,Post_peak
359,1938,50,500,7.51,17097,Post_peak
360,1938,51,595,8.94,17692,Peak
361,1938,52,835,12.55,18527,Peak
362,1939,1,545,8.03,545,Initial
363,1939,2,1189,17.52,1734,Pre-peak
364,1939,3,937,13.8,2671,Pre-peak
365,1939,4,1660,24.47,4331,Pre-peak
366,1939,5,1954,28.8,6285,Pre-peak
367,1939,6,2261,33.32,8546,Peak
368,1939,7,2534,37.35,11080,Peak
369,1939,8,3047,44.91,14127,Peak
370,1939,9,3845,56.67,17972,Peak
371,1939,10,3504,51.64,21476,Peak
372,1939,11,4248,62.61,25724,Peak
373,1939,12,4513,66.51,30237,Peak
374,1939,13,4154,61.22,34391,Peak
375,1939,14,2632,38.79,37023,Peak
376,1939,15,3482,51.32,40505,Peak
377,1939,16,3364,49.58,43869,Peak
378,1939,17,1603,23.62,45472,Post_peak
379,1939,18,1680,24.75,47152,Post_peak
380,1939,19,1427,21.02,48579,Post_peak
381,1939,20,1746,25.73,50325,Post_peak
382,1939,21,2285,33.68,52610,Peak
383,1939,22,1355,19.96,53965,Post_peak
384,1939,23,1936,28.53,55901,Post_peak
385,1939,24,1236,18.22,57137,Post_peak
386,1939,25,1038,15.3,58175,Post_peak
387,1939,26,787,11.6,58962,Post_peak
388,1939,27,481,7.09,59443,Post_peak
389,1939,28,479,7.06,59922,Post_peak
390,1939,29,315,4.64,60237,Receding
391,1939,30,177,2.61,60414,Receding
392,1939,31,177,2.61,60591,Receding
393,1939,32,93,1.37,60684,Receding
394,1939,33,97,1.43,60781,Receding
395,1939,34,49,0.72,60830,Receding
396,1939,35,53,0.78,60883,Receding
397,1939,36,21,0.31,60904,Receding
398,1939,37,38,0.56,60942,Receding
399,1939,38,44,0.65,60986,Receding
400,1939,39,101,1.49,61087,Receding
401,1939,40,123,1.81,61210,Receding
402,1939,42,105,1.55,61315,Receding
403,1939,43,167,2.46,61482,Receding
404,1939,44,149,2.2,61631,Receding
405,1939,45,111,1.64,61742,Receding
406,1939,46,133,1.96,61875,Receding
407,1939,47,149,2.2,62024,Receding
408,1939,48,349,5.14,62373,Receding
409,1939,49,503,7.41,62876,Post_peak
410,1939,50,525,7.73,63401,Post_peak
411,1939,51,190,2.8,63591,Receding
412,1939,52,157,2.31,63748,Receding
413,1940,1,90,1.29,90,Initial
414,1940,2,326,4.69,416,Initial
415,1940,3,246,3.54,662,Initial
416,1940,4,1207,17.37,1869,Peak
417,1940,5,1191,17.14,3060,Pre-peak
418,1940,6,1347,19.38,4407,Peak
419,1940,7,1454,20.92,5861,Peak
420,1940,8,408,5.87,6269,Pre-peak
421,1940,9,462,6.65,6731,Pre-peak
422,1940,10,417,6,7148,Pre-peak
423,1940,11,2391,34.4,9539,Peak
424,1940,12,2387,34.34,11926,Peak
425,1940,13,2299,33.08,14225,Peak
426,1940,14,1492,21.47,15717,Peak
427,1940,15,1969,28.32,17686,Peak
428,1940,16,1934,27.83,19620,Peak
429,1940,17,1395,20.07,21015,Peak
430,1940,19,373,5.37,21388,Post_peak
431,1940,20,420,6.04,21808,Post_peak
432,1940,21,272,3.91,22080,Post_peak
433,1940,22,354,5.09,22434,Post_peak
434,1940,23,491,7.06,22925,Post_peak
435,1940,24,260,3.74,23185,Post_peak
436,1940,25,606,8.72,23791,Post_peak
437,1940,26,496,7.13,24287,Post_peak
438,1940,27,309,4.44,24596,Post_peak
439,1940,28,304,4.37,24900,Post_peak
440,1940,29,203,2.92,25103,Receding
441,1940,30,88,1.27,25191,Receding
442,1940,31,130,1.86,25321,Receding
443,1940,32,88,1.26,25409,Receding
444,1940,34,40,0.58,25449,Receding
445,1940,35,40,0.57,25489,Receding
446,1940,36,23,0.33,25512,Receding
447,1940,37,42,0.6,25554,Receding
448,1940,39,47,0.68,25601,Receding
449,1940,40,35,0.5,25636,Receding
450,1940,41,57,0.82,25693,Receding
451,1940,42,48,0.69,25741,Receding
452,1940,43,73,1.05,25814,Receding
453,1940,44,25,0.36,25839,Receding
454,1940,45,21,0.3,25860,Receding
455,1940,46,27,0.39,25887,Receding
456,1940,47,63,0.91,25950,Receding
457,1940,48,51,0.73,26001,Receding
458,1940,49,84,1.21,26085,Receding
459,1940,50,44,0.63,26129,Receding
460,1940,52,38,0.55,26167,Receding
461,1942,1,1495,19.33,1495,Pre-peak
462,1942,2,1135,14.67,2630,Pre-peak
463,1942,3,1621,20.96,4251,Pre-peak
464,1942,4,863,11.16,5114,Pre-peak
465,1942,5,2501,32.33,7615,Pre-peak
466,1942,6,2317,29.95,9932,Pre-peak
467,1942,7,3161,40.87,13093,Pre-peak
468,1942,8,2931,37.89,16024,Pre-peak
469,1942,10,4867,62.92,20891,Peak
470,1942,11,5148,66.55,26039,Peak
471,1942,12,6343,82,32382,Peak
472,1942,13,5470,70.72,37852,Peak
473,1942,14,190,2.46,38042,Pre-peak
474,1942,15,6930,89.59,44972,Peak
475,1942,16,6074,78.53,51046,Peak
476,1942,17,6524,84.34,57570,Peak
477,1942,18,5724,74,63294,Peak
478,1942,19,4988,64.49,68282,Peak
479,1942,20,5359,69.28,73641,Peak
480,1942,21,2849,36.83,76490,Post_peak
481,1942,22,4202,54.32,80692,Peak
482,1942,23,3367,43.53,84059,Post_peak
483,1942,24,3648,47.16,87707,Peak
484,1942,25,1968,25.44,89675,Post_peak
485,1942,26,1110,14.35,90785,Post_peak
486,1942,27,856,11.07,91641,Post_peak
487,1942,28,512,6.62,92153,Receding
488,1942,29,442,5.71,92595,Receding
489,1942,30,292,3.78,92887,Receding
490,1942,31,164,2.12,93051,Receding
491,1942,32,133,1.72,93184,Receding
492,1942,33,65,0.84,93249,Receding
493,1942,34,101,1.31,93350,Receding
494,1942,35,62,0.8,93412,Receding
495,1942,36,47,0.61,93459,Receding
496,1942,37,49,0.63,93508,Receding
497,1942,38,49,0.63,93557,Receding
498,1942,39,42,0.54,93599,Receding
499,1942,40,56,0.72,93655,Receding
500,1942,42,40,0.52,93695,Receding
501,1942,43,125,1.61,93820,Receding
502,1942,44,40,0.52,93860,Receding
503,1942,45,41,0.53,93901,Receding
504,1942,46,39,0.5,93940,Receding
505,1942,47,60,0.78,94000,Receding
506,1942,48,285,3.68,94285,Receding
507,1942,49,66,0.85,94351,Receding
508,1942,50,81,1.05,94432,Receding
509,1942,51,44,0.57,94476,Receding
510,1942,52,49,0.63,94525,Receding
511,1943,1,147,1.73,147,Initial
512,1943,2,212,2.49,359,Initial
513,1943,3,177,2.08,536,Initial
514,1943,4,931,10.94,1467,Pre-peak
515,1943,5,425,5,1892,Pre-peak
516,1943,6,372,4.37,2264,Pre-peak
517,1943,7,383,4.5,2647,Pre-peak
518,1943,8,481,5.65,3128,Pre-peak
519,1943,9,741,8.71,3869,Pre-peak
520,1943,10,721,8.48,4590,Pre-peak
521,1943,11,742,8.72,5332,Pre-peak
522,1943,12,1127,13.25,6459,Pre-peak
523,1943,13,3141,36.93,9600,Peak
524,1943,14,1032,12.13,10632,Pre-peak
525,1943,15,4067,47.81,14699,Peak
526,1943,16,842,9.9,15541,Post_peak
527,1943,17,854,10.04,16395,Post_peak
528,1943,18,1186,13.94,17581,Post_peak
529,1943,19,1218,14.32,18799,Post_peak
530,1943,20,1053,12.38,19852,Post_peak
531,1943,21,2996,35.22,22848,Peak
532,1943,23,1163,13.67,24011,Post_peak
533,1943,24,809,9.51,24820,Post_peak
534,1943,25,1331,15.64,26151,Post_peak
535,1943,26,362,4.26,26513,Receding
536,1943,27,366,4.3,26879,Receding
537,1943,28,324,3.81,27203,Receding
538,1943,30,201,2.36,27404,Receding
539,1943,31,151,1.78,27555,Receding
540,1943,32,126,1.48,27681,Receding
541,1943,33,110,1.29,27791,Receding
542,1943,34,103,1.21,27894,Receding
543,1943,35,54,0.63,27948,Receding
544,1943,36,55,0.65,28003,Receding
545,1943,38,35,0.41,28038,Receding
546,1943,39,92,1.08,28130,Receding
547,1943,40,41,0.48,28171,Receding
548,1943,41,43,0.51,28214,Receding
549,1943,42,45,0.53,28259,Receding
550,1943,43,57,0.67,28316,Receding
551,1943,44,53,0.62,28369,Receding
552,1943,45,35,0.41,28404,Receding
553,1943,46,64,0.75,28468,Receding
554,1943,48,101,1.19,28569,Receding
555,1943,49,105,1.23,28674,Receding
556,1943,51,87,1.02,28761,Receding
557,1943,52,168,1.98,28929,Receding
558,1944,2,258,2.88,29187,Pre-peak
559,1944,3,273,3.05,29460,Pre-peak
560,1944,4,499,5.58,29959,Pre-peak
561,1944,5,766,8.56,30725,Pre-peak
562,1944,7,621,6.94,31346,Pre-peak
563,1944,8,752,8.41,32098,Pre-peak
564,1944,9,1712,19.14,33810,Pre-peak
565,1944,10,1598,17.86,35408,Pre-peak
566,1944,11,2094,23.41,37502,Pre-peak
567,1944,12,2584,28.89,40086,Peak
568,1944,13,2705,30.24,42791,Peak
569,1944,14,2920,32.64,45711,Peak
570,1944,15,2795,31.25,48506,Peak
571,1944,16,4077,45.58,52583,Peak
572,1944,18,2399,26.82,54982,Peak
573,1944,19,3083,34.46,58065,Peak
574,1944,20,4371,48.87,62436,Peak
575,1944,21,3378,37.76,65814,Peak
576,1944,22,3325,37.17,69139,Peak
577,1944,23,3384,37.83,72523,Peak
578,1944,24,2729,30.51,75252,Peak
579,1944,26,1371,15.33,76623,Post_peak
580,1944,27,841,9.4,77464,Post_peak
581,1944,28,641,7.17,78105,Post_peak
582,1944,29,442,4.94,78547,Post_peak
583,1944,30,482,5.39,79029,Post_peak
584,1944,31,335,3.75,79364,Receding
585,1944,32,291,3.25,79655,Receding
586,1944,33,140,1.57,79795,Receding
587,1944,34,149,1.67,79944,Receding
588,1944,35,150,1.68,80094,Receding
589,1944,36,92,1.03,80186,Receding
590,1944,37,88,0.98,80274,Receding
591,1944,38,107,1.2,80381,Receding
592,1944,39,110,1.23,80491,Receding
593,1944,40,114,1.27,80605,Receding
594,1944,41,180,2.01,80785,Receding
595,1944,42,147,1.64,80932,Receding
596,1944,43,152,1.7,81084,Receding
597,1944,44,191,2.14,81275,Receding
598,1944,45,135,1.51,81410,Receding
599,1944,46,157,1.76,81567,Receding
600,1944,47,104,1.16,81671,Receding
601,1944,49,249,2.78,81920,Receding
602,1944,50,237,2.65,82157,Receding
603,1944,51,202,2.26,82359,Receding
604,1944,52,237,2.65,82596,Receding
605,1945,1,210,2.25,210,Initial
606,1945,2,470,5.03,680,Initial
607,1945,3,330,3.53,1010,Pre-peak
608,1945,4,430,4.6,1440,Pre-peak
609,1945,5,426,4.56,1866,Pre-peak
610,1945,6,556,5.95,2422,Pre-peak
611,1945,7,683,7.31,3105,Pre-peak
612,1945,8,677,7.25,3782,Pre-peak
613,1945,9,843,9.02,4625,Pre-peak
614,1945,10,953,10.2,5578,Pre-peak
615,1945,11,1187,12.7,6765,Pre-peak
616,1945,12,1226,13.12,7991,Peak
617,1945,13,1924,20.59,9915,Peak
618,1945,14,1057,11.31,10972,Pre-peak
619,1945,15,1536,16.44,12508,Peak
620,1945,16,1139,12.19,13647,Pre-peak
621,1945,17,1360,14.55,15007,Peak
622,1945,18,1267,13.56,16274,Peak
623,1945,19,1510,16.16,17784,Peak
624,1945,20,1451,15.53,19235,Peak
625,1945,21,2421,25.9,21656,Peak
626,1945,22,1308,14,22964,Peak
627,1945,23,1458,15.6,24422,Peak
628,1945,24,1075,11.5,25497,Post_peak
629,1945,25,944,10.1,26441,Post_peak
630,1945,26,667,7.14,27108,Post_peak
631,1945,27,477,5.1,27585,Post_peak
632,1945,28,373,3.99,27958,Post_peak
633,1945,30,354,3.79,28312,Post_peak
634,1945,31,234,2.5,28546,Receding
635,1945,32,196,2.1,28742,Receding
636,1945,33,189,2.02,28931,Receding
637,1945,34,129,1.38,29060,Receding
638,1945,35,129,1.38,29189,Receding
639,1945,36,59,0.63,29248,Receding
640,1945,37,101,1.08,29349,Receding
641,1945,38,148,1.58,29497,Receding
642,1945,39,110,1.18,29607,Receding
643,1945,40,126,1.35,29733,Receding
644,1945,41,169,1.8,29902,Receding
645,1945,42,181,1.94,30083,Receding
646,1945,43,191,2.04,30274,Receding
647,1945,44,222,2.38,30496,Receding
648,1945,45,223,2.39,30719,Receding
649,1945,46,236,2.53,30955,Receding
650,1945,49,333,3.56,31288,Post_peak
651,1945,51,287,3.07,31575,Post_peak
652,1945,52,146,1.56,31721,Receding
653,1946,1,414,4.33,414,Initial
654,1946,2,682,7.13,1096,Pre-peak
655,1946,3,529,5.53,1625,Pre-peak
656,1946,4,759,7.94,2384,Pre-peak
657,1946,5,941,9.84,3325,Pre-peak
658,1946,6,1082,11.32,4407,Pre-peak
659,1946,7,1331,13.92,5738,Pre-peak
660,1946,8,1362,14.25,7100,Pre-peak
661,1946,9,2386,24.96,9486,Peak
662,1946,10,2848,29.79,12334,Peak
663,1946,11,2871,30.03,15205,Peak
664,1946,12,2157,22.56,17362,Peak
665,1946,13,3047,31.88,20409,Peak
666,1946,14,3634,38.02,24043,Peak
667,1946,15,2680,28.03,26723,Peak
668,1946,16,3374,35.3,30097,Peak
669,1946,17,3657,38.26,33754,Peak
670,1946,18,3976,41.59,37730,Peak
671,1946,19,2968,31.05,40698,Peak
672,1946,20,2665,27.88,43363,Peak
673,1946,21,1785,18.67,45148,Post_peak
674,1946,22,1883,19.7,47031,Post_peak
675,1946,23,1762,18.43,48793,Post_peak
676,1946,24,1497,15.66,50290,Post_peak
677,1946,25,1251,13.09,51541,Post_peak
678,1946,26,654,6.84,52195,Post_peak
679,1946,27,459,4.8,52654,Post_peak
680,1946,28,414,4.33,53068,Post_peak
681,1946,29,246,2.57,53314,Receding
682,1946,30,213,2.23,53527,Receding
683,1946,31,135,1.41,53662,Receding
684,1946,32,105,1.1,53767,Receding
685,1946,33,83,0.87,53850,Receding
686,1946,34,40,0.42,53890,Receding
687,1946,35,64,0.67,53954,Receding
688,1946,36,38,0.4,53992,Receding
689,1946,37,47,0.49,54039,Receding
690,1946,38,38,0.4,54077,Receding
691,1946,39,43,0.45,54120,Receding
692,1946,40,56,0.59,54176,Receding
693,1946,41,59,0.62,54235,Receding
694,1946,42,87,0.91,54322,Receding
695,1946,43,60,0.63,54382,Receding
696,1946,44,40,0.42,54422,Receding
697,1946,45,72,0.75,54494,Receding
698,1946,46,45,0.47,54539,Receding
699,1946,47,105,1.1,54644,Receding
700,1946,48,65,0.68,54709,Receding
701,1946,49,123,1.29,54832,Receding
702,1946,50,73,0.76,54905,Receding
703,1946,51,59,0.62,54964,Receding
704,1946,52,17,0.18,54981,Receding
705,1948,1,490,4.87,490,Initial
706,1948,2,238,2.36,728,Initial
707,1948,3,372,3.7,1100,Pre-peak
708,1948,4,538,5.35,1638,Pre-peak
709,1948,5,538,5.35,2176,Pre-peak
710,1948,6,594,5.9,2770,Pre-peak
711,1948,7,660,6.56,3430,Pre-peak
712,1948,8,1022,10.16,4452,Pre-peak
713,1948,10,1747,17.36,6199,Pre-peak
714,1948,11,1935,19.23,8134,Peak
715,1948,12,2061,20.48,10195,Peak
716,1948,13,2744,27.27,12939,Peak
717,1948,14,3353,33.32,16292,Peak
718,1948,15,3258,32.37,19550,Peak
719,1948,16,3279,32.58,22829,Peak
720,1948,17,3854,38.29,26683,Peak
721,1948,18,3344,33.23,30027,Peak
722,1948,19,3770,37.46,33797,Peak
723,1948,21,3364,33.43,37161,Peak
724,1948,23,3187,31.67,40348,Peak
725,1948,24,2498,24.82,42846,Peak
726,1948,25,1573,15.63,44419,Post_peak
727,1948,26,986,9.8,45405,Post_peak
728,1948,27,863,8.58,46268,Post_peak
729,1948,31,218,2.17,46486,Receding
730,1948,32,171,1.7,46657,Receding
731,1948,35,72,0.72,46729,Receding
732,1948,36,48,0.48,46777,Receding
733,1948,37,48,0.48,46825,Receding
734,1948,38,70,0.7,46895,Receding
735,1948,39,70,0.7,46965,Receding
736,1948,40,35,0.35,47000,Receding
737,1948,41,84,0.83,47084,Receding
738,1948,42,78,0.78,47162,Receding
739,1948,43,38,0.38,47200,Receding
740,1948,44,126,1.25,47326,Receding
741,1948,45,122,1.21,47448,Receding
742,1948,46,190,1.89,47638,Receding
743,1948,47,172,1.71,47810,Receding
744,1948,48,188,1.87,47998,Receding
745,1948,49,267,2.65,48265,Receding
746,1948,50,370,3.68,48635,Receding
747,1948,51,257,2.55,48892,Receding
748,1948,52,205,2.04,49097,Receding
749,1949,1,587,5.68,587,Initial
750,1949,2,584,5.65,1171,Pre-peak
751,1949,3,685,6.63,1856,Pre-peak
752,1949,4,890,8.61,2746,Pre-peak
753,1949,5,655,6.34,3401,Pre-peak
754,1949,6,1248,12.07,4649,Peak
755,1949,7,709,6.86,5358,Pre-peak
756,1949,8,1100,10.64,6458,Pre-peak
757,1949,9,1559,15.08,8017,Peak
758,1949,10,2017,19.51,10034,Peak
759,1949,11,1638,15.85,11672,Peak
760,1949,12,1833,17.73,13505,Peak
761,1949,13,2230,21.57,15735,Peak
762,1949,14,2167,20.96,17902,Peak
763,1949,15,1598,15.46,19500,Peak
764,1949,16,1261,12.2,20761,Peak
765,1949,17,1631,15.78,22392,Peak
766,1949,18,1281,12.39,23673,Peak
767,1949,19,1411,13.65,25084,Peak
768,1949,20,1082,10.47,26166,Post_peak
769,1949,21,996,9.64,27162,Post_peak
770,1949,22,941,9.1,28103,Post_peak
771,1949,23,1148,11.11,29251,Peak
772,1949,24,877,8.48,30128,Post_peak
773,1949,25,628,6.08,30756,Post_peak
774,1949,26,392,3.79,31148,Post_peak
775,1949,27,257,2.49,31405,Post_peak
776,1949,28,211,2.04,31616,Receding
777,1949,29,153,1.48,31769,Receding
778,1949,30,125,1.21,31894,Receding
779,1949,31,109,1.05,32003,Receding
780,1949,32,75,0.73,32078,Receding
781,1949,33,66,0.64,32144,Receding
782,1949,34,50,0.48,32194,Receding
783,1949,35,72,0.7,32266,Receding
784,1949,36,42,0.41,32308,Receding
785,1949,37,55,0.53,32363,Receding
786,1949,38,42,0.41,32405,Receding
787,1949,39,33,0.32,32438,Receding
788,1949,40,38,0.37,32476,Receding
789,1949,41,32,0.31,32508,Receding
790,1949,42,38,0.37,32546,Receding
791,1949,43,41,0.4,32587,Receding
792,1949,44,29,0.28,32616,Receding
793,1949,45,35,0.34,32651,Receding
794,1949,46,72,0.7,32723,Receding
795,1949,47,68,0.66,32791,Receding
796,1949,48,51,0.49,32842,Receding
797,1949,49,78,0.75,32920,Receding
798,1949,50,63,0.61,32983,Receding
799,1949,51,78,0.75,33061,Receding
800,1949,52,100,0.97,33161,Receding
801,1951,1,336,3.02,336,Initial
802,1951,2,466,4.19,802,Initial
803,1951,3,550,4.94,1352,Pre-peak
804,1951,4,890,7.99,2242,Pre-peak
805,1951,5,1149,10.32,3391,Pre-peak
806,1951,6,976,8.77,4367,Pre-peak
807,1951,7,1159,10.41,5526,Pre-peak
808,1951,8,1637,14.7,7163,Pre-peak
809,1951,9,1781,16,8944,Pre-peak
810,1951,10,2232,20.05,11176,Peak
811,1951,11,2125,19.09,13301,Peak
812,1951,12,2122,19.06,15423,Peak
813,1951,13,2745,24.65,18168,Peak
814,1951,14,3104,27.88,21272,Peak
815,1951,15,3152,28.31,24424,Peak
816,1951,16,3456,31.04,27880,Peak
817,1951,17,3807,34.19,31687,Peak
818,1951,18,3724,33.45,35411,Peak
819,1951,19,3827,34.37,39238,Peak
820,1951,20,3641,32.7,42879,Peak
821,1951,21,3654,32.82,46533,Peak
822,1951,22,2676,24.03,49209,Peak
823,1951,23,3321,29.83,52530,Peak
824,1951,24,1654,14.86,54184,Post_peak
825,1951,25,1354,12.16,55538,Post_peak
826,1951,26,1077,9.67,56615,Post_peak
827,1951,27,694,6.23,57309,Post_peak
828,1951,28,737,6.62,58046,Post_peak
829,1951,29,413,3.71,58459,Post_peak
830,1951,30,382,3.43,58841,Receding
831,1951,31,324,2.91,59165,Receding
832,1951,32,165,1.48,59330,Receding
833,1951,33,134,1.2,59464,Receding
834,1951,34,123,1.1,59587,Receding
835,1951,35,118,1.06,59705,Receding
836,1951,36,67,0.6,59772,Receding
837,1951,37,43,0.39,59815,Receding
838,1951,38,88,0.79,59903,Receding
839,1951,39,59,0.53,59962,Receding
840,1951,40,92,0.83,60054,Receding
841,1951,41,74,0.66,60128,Receding
842,1951,42,97,0.87,60225,Receding
843,1951,43,99,0.89,60324,Receding
844,1951,44,96,0.86,60420,Receding
845,1951,45,145,1.3,60565,Receding
846,1951,46,101,0.91,60666,Receding
847,1951,47,109,0.98,60775,Receding
848,1951,48,105,0.94,60880,Receding
849,1951,49,175,1.57,61055,Receding
850,1952,1,77,0.66,77,Initial
851,1952,2,170,1.46,247,Initial
852,1952,3,261,2.24,508,Initial
853,1952,4,267,2.29,775,Initial
854,1952,5,333,2.86,1108,Pre-peak
855,1952,6,439,3.77,1547,Pre-peak
856,1952,7,496,4.26,2043,Pre-peak
857,1952,8,1074,9.23,3117,Pre-peak
858,1952,10,1018,8.75,4135,Pre-peak
859,1952,11,1565,13.45,5700,Pre-peak
860,1952,12,1475,12.68,7175,Pre-peak
861,1952,13,2175,18.69,9350,Pre-peak
862,1952,14,2566,22.05,11916,Pre-peak
863,1952,15,1022,8.78,12938,Pre-peak
864,1952,16,1739,14.95,14677,Pre-peak
865,1952,17,2958,25.42,17635,Peak
866,1952,19,1607,13.81,19242,Pre-peak
867,1952,20,5584,47.99,24826,Peak
868,1952,21,2812,24.17,27638,Peak
869,1952,22,1989,17.09,29627,Post_peak
870,1952,24,2244,19.29,31871,Post_peak
871,1952,25,1289,11.08,33160,Post_peak
872,1952,26,586,5.04,33746,Post_peak
873,1952,27,702,6.03,34448,Post_peak
874,1952,28,658,5.66,35106,Post_peak
875,1952,29,469,4.03,35575,Receding
876,1952,30,455,3.91,36030,Receding
877,1952,31,278,2.39,36308,Receding
878,1952,32,209,1.79,36517,Receding
879,1952,33,140,1.2,36657,Receding
880,1952,34,175,1.5,36832,Receding
881,1952,35,96,0.83,36928,Receding
882,1952,36,64,0.55,36992,Receding
883,1952,37,45,0.38,37037,Receding
884,1952,38,87,0.75,37124,Receding
885,1952,39,67,0.57,37191,Receding
886,1952,40,91,0.78,37282,Receding
887,1952,41,92,0.79,37374,Receding
888,1952,42,116,1,37490,Receding
889,1952,43,94,0.81,37584,Receding
890,1952,44,125,1.07,37709,Receding
891,1952,45,142,1.22,37851,Receding
892,1952,46,169,1.45,38020,Receding
893,1952,47,146,1.25,38166,Receding
894,1952,48,122,1.04,38288,Receding
895,1952,49,187,1.6,38475,Receding
896,1952,50,191,1.64,38666,Receding
897,1952,51,230,1.97,38896,Receding
898,1952,52,120,1.03,39016,Receding
899,1953,1,27,0.22,27,Initial
900,1953,2,366,2.99,393,Initial
901,1953,3,534,4.36,927,Initial
902,1953,4,500,4.08,1427,Pre-peak
903,1953,5,613,5,2040,Pre-peak
904,1953,6,467,3.81,2507,Pre-peak
905,1953,7,572,4.67,3079,Pre-peak
906,1953,8,1042,8.51,4121,Pre-peak
907,1953,9,1120,9.14,5241,Pre-peak
908,1953,10,1175,9.59,6416,Pre-peak
909,1953,11,1399,11.42,7815,Pre-peak
910,1953,12,1536,12.54,9351,Pre-peak
911,1953,13,1228,10.02,10579,Pre-peak
912,1953,14,1351,11.03,11930,Pre-peak
913,1953,15,2174,17.75,14104,Peak
914,1953,16,2124,17.34,16228,Peak
915,1953,17,2741,22.37,18969,Peak
916,1953,18,2937,23.97,21906,Peak
917,1953,19,3101,25.31,25007,Peak
918,1953,20,3324,27.13,28331,Peak
919,1953,21,3099,25.3,31430,Peak
920,1953,22,3631,29.64,35061,Peak
921,1953,23,3666,29.92,38727,Peak
922,1953,24,3392,27.69,42119,Peak
923,1953,25,2192,17.89,44311,Peak
924,1953,26,1563,12.76,45874,Post_peak
925,1953,27,1173,9.57,47047,Post_peak
926,1953,28,1192,9.73,48239,Post_peak
927,1953,29,922,7.53,49161,Post_peak
928,1953,30,564,4.6,49725,Post_peak
929,1953,31,453,3.7,50178,Post_peak
930,1953,32,331,2.7,50509,Receding
931,1953,33,232,1.89,50741,Receding
932,1953,34,182,1.49,50923,Receding
933,1953,35,108,0.88,51031,Receding
934,1953,36,129,1.05,51160,Receding
935,1953,37,121,0.99,51281,Receding
936,1953,38,87,0.71,51368,Receding
937,1953,39,96,0.78,51464,Receding
938,1953,40,136,1.11,51600,Receding
939,1953,41,125,1.02,51725,Receding
940,1953,42,191,1.56,51916,Receding
941,1953,43,204,1.67,52120,Receding
942,1953,44,250,2.04,52370,Receding
943,1953,45,198,1.62,52568,Receding
944,1953,46,258,2.11,52826,Receding
945,1953,48,270,2.2,53096,Receding
946,1953,49,354,2.89,53450,Receding
947,1953,50,321,2.62,53771,Receding
948,1954,1,621,4.87,621,Initial
949,1954,2,685,5.37,1306,Pre-peak
950,1954,3,715,5.61,2021,Pre-peak
951,1954,4,841,6.6,2862,Pre-peak
952,1954,5,1008,7.91,3870,Pre-peak
953,1954,6,888,6.97,4758,Pre-peak
954,1954,7,1086,8.52,5844,Pre-peak
955,1954,8,1569,12.31,7413,Pre-peak
956,1954,9,1593,12.5,9006,Pre-peak
957,1954,10,1662,13.04,10668,Pre-peak
958,1954,11,1773,13.91,12441,Peak
959,1954,12,2210,17.34,14651,Peak
960,1954,13,2408,18.89,17059,Peak
961,1954,14,2855,22.4,19914,Peak
962,1954,15,2637,20.69,22551,Peak
963,1954,16,2232,17.51,24783,Peak
964,1954,17,3222,25.28,28005,Peak
965,1954,18,2701,21.19,30706,Peak
966,1954,19,3361,26.37,34067,Peak
967,1954,20,3005,23.58,37072,Peak
968,1954,21,2978,23.36,40050,Peak
969,1954,22,2597,20.38,42647,Peak
970,1954,23,3409,26.75,46056,Peak
971,1954,24,2705,21.22,48761,Peak
972,1954,25,2324,18.23,51085,Peak
973,1954,26,1363,10.69,52448,Post_peak
974,1954,27,1037,8.14,53485,Post_peak
975,1954,28,1133,8.89,54618,Post_peak
976,1954,29,697,5.47,55315,Post_peak
977,1954,30,641,5.03,55956,Post_peak
978,1954,31,379,2.97,56335,Post_peak
979,1954,32,275,2.16,56610,Receding
980,1954,33,259,2.03,56869,Receding
981,1954,34,158,1.24,57027,Receding
982,1954,35,146,1.15,57173,Receding
983,1954,36,65,0.51,57238,Receding
984,1954,37,126,0.99,57364,Receding
985,1954,38,102,0.8,57466,Receding
986,1954,39,85,0.67,57551,Receding
987,1954,40,102,0.8,57653,Receding
988,1954,41,101,0.79,57754,Receding
989,1954,42,145,1.14,57899,Receding
990,1954,43,165,1.29,58064,Receding
991,1954,44,132,1.04,58196,Receding
992,1954,45,172,1.35,58368,Receding
993,1954,46,258,2.02,58626,Receding
994,1954,47,185,1.45,58811,Receding
995,1954,48,190,1.49,59001,Receding
996,1954,49,372,2.92,59373,Post_peak
997,1954,50,325,2.55,59698,Receding
998,1954,51,268,2.1,59966,Receding
999,1954,52,327,2.57,60293,Receding
1000,1955,1,319,2.43,319,Initial
1001,1955,2,695,5.29,1014,Pre-peak
1002,1955,3,462,3.52,1476,Pre-peak
1003,1955,4,673,5.12,2149,Pre-peak
1004,1955,5,803,6.11,2952,Pre-peak
1005,1955,6,1217,9.27,4169,Pre-peak
1006,1955,8,1348,10.26,5517,Pre-peak
1007,1955,9,2364,18,7881,Peak
1008,1955,10,2604,19.83,10485,Peak
1009,1955,11,2595,19.76,13080,Peak
1010,1955,12,3087,23.51,16167,Peak
1011,1955,13,3164,24.09,19331,Peak
1012,1955,14,4145,31.56,23476,Peak
1013,1955,15,2724,20.74,26200,Peak
1014,1955,16,3821,29.09,30021,Peak
1015,1955,17,3602,27.43,33623,Peak
1016,1955,18,3902,29.71,37525,Peak
1017,1955,19,4194,31.93,41719,Peak
1018,1955,20,3824,29.12,45543,Peak
1019,1955,21,3466,26.39,49009,Peak
1020,1955,22,2831,21.56,51840,Peak
1021,1955,23,3157,24.04,54997,Peak
1022,1955,24,2618,19.93,57615,Peak
1023,1955,25,1955,14.89,59570,Post_peak
1024,1955,26,1062,8.09,60632,Post_peak
1025,1955,27,828,6.3,61460,Post_peak
1026,1955,28,753,5.73,62213,Post_peak
1027,1955,29,587,4.47,62800,Post_peak
1028,1955,30,478,3.64,63278,Post_peak
1029,1955,31,267,2.03,63545,Receding
1030,1955,32,280,2.13,63825,Receding
1031,1955,33,179,1.36,64004,Receding
1032,1955,34,100,0.76,64104,Receding
1033,1955,36,76,0.58,64180,Receding
1034,1955,37,160,1.22,64340,Receding
1035,1955,38,116,0.88,64456,Receding
1036,1955,39,104,0.79,64560,Receding
1037,1955,40,106,0.81,64666,Receding
1038,1955,41,152,1.16,64818,Receding
1039,1955,42,190,1.45,65008,Receding
1040,1955,43,153,1.17,65161,Receding
1041,1955,44,220,1.68,65381,Receding
1042,1955,45,196,1.49,65577,Receding
1043,1955,46,258,1.96,65835,Receding
1044,1955,47,290,2.21,66125,Receding
1045,1955,48,282,2.15,66407,Receding
1046,1955,49,376,2.86,66783,Receding
1047,1955,51,479,3.65,67262,Post_peak
1048,1955,52,172,1.31,67434,Receding
1049,1956,1,286,2.09,286,Initial
1050,1956,2,416,3.03,702,Initial
1051,1956,3,633,4.62,1335,Pre-peak
1052,1956,4,498,3.63,1833,Pre-peak
1053,1956,5,614,4.48,2447,Pre-peak
1054,1956,6,455,3.32,2902,Pre-peak
1055,1956,7,691,5.04,3593,Pre-peak
1056,1956,8,471,3.43,4064,Pre-peak
1057,1956,9,982,7.16,5046,Peak
1058,1956,10,980,7.15,6026,Peak
1059,1956,11,867,6.32,6893,Pre-peak
1060,1956,12,585,4.27,7478,Pre-peak
1061,1956,13,1274,9.29,8752,Peak
1062,1956,14,788,5.75,9540,Pre-peak
1063,1956,15,1601,11.68,11141,Peak
1064,1956,16,1288,9.39,12429,Peak
1065,1956,17,1326,9.67,13755,Peak
1066,1956,18,1916,13.97,15671,Peak
1067,1956,19,1400,10.21,17071,Peak
1068,1956,20,1748,12.75,18819,Peak
1069,1956,21,1517,11.06,20336,Peak
1070,1956,22,1301,9.49,21637,Peak
1071,1956,23,1592,11.61,23229,Peak
1072,1956,24,1839,13.41,25068,Peak
1073,1956,25,1155,8.42,26223,Peak
1074,1956,26,610,4.45,26833,Post_peak
1075,1956,27,407,2.97,27240,Post_peak
1076,1956,28,610,4.45,27850,Post_peak
1077,1956,29,327,2.38,28177,Post_peak
1078,1956,30,254,1.85,28431,Post_peak
1079,1956,31,302,2.2,28733,Post_peak
1080,1956,32,182,1.33,28915,Receding
1081,1956,33,165,1.2,29080,Receding
1082,1956,34,109,0.79,29189,Receding
1083,1956,35,104,0.76,29293,Receding
1084,1956,36,76,0.55,29369,Receding
1085,1956,37,89,0.65,29458,Receding
1086,1956,38,110,0.8,29568,Receding
1087,1956,39,130,0.95,29698,Receding
1088,1956,40,112,0.82,29810,Receding
1089,1956,41,46,0.34,29856,Receding
1090,1956,42,105,0.77,29961,Receding
1091,1956,43,118,0.86,30079,Receding
1092,1956,44,84,0.61,30163,Receding
1093,1956,45,102,0.74,30265,Receding
1094,1956,46,225,1.64,30490,Post_peak
1095,1956,47,194,1.41,30684,Post_peak
1096,1956,48,218,1.59,30902,Post_peak
1097,1956,49,276,2.01,31178,Post_peak
1098,1956,50,319,2.33,31497,Post_peak
1099,1956,51,135,0.98,31632,Receding
1100,1956,52,622,4.54,32254,Post_peak
1101,1957,1,700,4.91,700,Initial
1102,1957,2,843,5.91,1543,Pre-peak
1103,1957,3,1013,7.1,2556,Pre-peak
1104,1957,4,1473,10.33,4029,Pre-peak
1105,1957,5,1312,9.2,5341,Pre-peak
1106,1957,6,1906,13.36,7247,Peak
1107,1957,7,1631,11.43,8878,Pre-peak
1108,1957,8,2072,14.53,10950,Peak
1109,1957,9,2675,18.75,13625,Peak
1110,1957,10,2525,17.7,16150,Peak
1111,1957,11,2699,18.92,18849,Peak
1112,1957,12,2373,16.64,21222,Peak
1113,1957,13,3403,23.86,24625,Peak
1114,1957,14,2766,19.39,27391,Peak
1115,1957,15,2866,20.09,30257,Peak
1116,1957,16,2395,16.79,32652,Peak
1117,1957,17,1683,11.8,34335,Post_peak
1118,1957,18,2185,15.32,36520,Peak
1119,1957,20,1922,13.47,38442,Peak
1120,1957,21,1729,12.12,40171,Peak
1121,1957,22,1335,9.36,41506,Post_peak
1122,1957,23,1621,11.36,43127,Post_peak
1123,1957,24,1573,11.03,44700,Post_peak
1124,1957,25,881,6.18,45581,Post_peak
1125,1957,26,954,6.69,46535,Post_peak
1126,1957,27,437,3.06,46972,Post_peak
1127,1957,28,481,3.37,47453,Post_peak
1128,1957,29,335,2.35,47788,Receding
1129,1957,30,270,1.89,48058,Receding
1130,1957,31,211,1.48,48269,Receding
1131,1957,32,139,0.97,48408,Receding
1132,1957,33,103,0.72,48511,Receding
1133,1957,34,112,0.79,48623,Receding
1134,1957,35,96,0.67,48719,Receding
1135,1957,36,28,0.2,48747,Receding
1136,1957,37,48,0.34,48795,Receding
1137,1957,38,59,0.41,48854,Receding
1138,1957,39,68,0.48,48922,Receding
1139,1957,40,55,0.39,48977,Receding
1140,1957,41,75,0.53,49052,Receding
1141,1957,42,116,0.81,49168,Receding
1142,1957,43,108,0.76,49276,Receding
1143,1957,44,80,0.56,49356,Receding
1144,1957,45,83,0.58,49439,Receding
1145,1957,46,98,0.69,49537,Receding
1146,1957,47,90,0.63,49627,Receding
1147,1957,48,205,1.44,49832,Receding
1148,1957,49,150,1.05,49982,Receding
1149,1957,50,126,0.88,50108,Receding
1150,1957,51,166,1.16,50274,Receding
1151,1957,52,129,0.9,50403,Receding
1152,1958,1,161,1.08,161,Initial
1153,1958,2,207,1.39,368,Initial
1154,1958,3,443,2.98,811,Initial
1155,1958,4,312,2.1,1123,Pre-peak
1156,1958,5,524,3.52,1647,Pre-peak
1157,1958,6,663,4.46,2310,Pre-peak
1158,1958,7,495,3.33,2805,Pre-peak
1159,1958,8,472,3.17,3277,Pre-peak
1160,1958,10,1295,8.7,4572,Peak
1161,1958,11,1231,8.27,5803,Peak
1162,1958,12,1073,7.21,6876,Pre-peak
1163,1958,13,1553,10.44,8429,Peak
1164,1958,14,1217,8.18,9646,Peak
1165,1958,15,1234,8.29,10880,Peak
1166,1958,16,1821,12.24,12701,Peak
1167,1958,17,1909,12.83,14610,Peak
1168,1958,18,1714,11.52,16324,Peak
1169,1958,19,2149,14.44,18473,Peak
1170,1958,20,1928,12.96,20401,Peak
1171,1958,21,1861,12.51,22262,Peak
1172,1958,22,1017,6.83,23279,Post_peak
1173,1958,23,2051,13.78,25330,Peak
1174,1958,24,1499,10.07,26829,Peak
1175,1958,25,1391,9.35,28220,Peak
1176,1958,26,921,6.19,29141,Post_peak
1177,1958,27,542,3.64,29683,Post_peak
1178,1958,28,588,3.95,30271,Post_peak
1179,1958,29,458,3.08,30729,Post_peak
1180,1958,30,360,2.42,31089,Post_peak
1181,1958,31,260,1.75,31349,Post_peak
1182,1958,32,229,1.54,31578,Post_peak
1183,1958,33,224,1.51,31802,Post_peak
1184,1958,34,99,0.67,31901,Receding
1185,1958,35,65,0.44,31966,Receding
1186,1958,36,106,0.71,32072,Receding
1187,1958,37,78,0.52,32150,Receding
1188,1958,38,65,0.44,32215,Receding
1189,1958,39,63,0.42,32278,Receding
1190,1958,40,104,0.7,32382,Receding
1191,1958,41,51,0.34,32433,Receding
1192,1958,42,159,1.07,32592,Receding
1193,1958,43,153,1.03,32745,Receding
1194,1958,44,220,1.48,32965,Post_peak
1195,1958,45,228,1.53,33193,Post_peak
1196,1958,46,163,1.1,33356,Receding
1197,1958,47,213,1.43,33569,Receding
1198,1958,48,253,1.7,33822,Post_peak
1199,1958,49,268,1.8,34090,Post_peak
1200,1958,50,445,2.99,34535,Post_peak
1201,1958,51,270,1.81,34805,Post_peak
1202,1958,52,269,1.81,35074,Post_peak
1203,1959,1,499,3.23,499,Initial
1204,1959,2,661,4.27,1160,Pre-peak
1205,1959,3,684,4.42,1844,Pre-peak
1206,1959,4,808,5.22,2652,Pre-peak
1207,1959,5,820,5.3,3472,Pre-peak
1208,1959,6,692,4.47,4164,Pre-peak
1209,1959,7,935,6.05,5099,Pre-peak
1210,1959,8,1870,12.09,6969,Peak
1211,1959,9,1466,9.48,8435,Peak
1212,1959,10,2517,16.27,10952,Peak
1213,1959,11,2105,13.61,13057,Peak
1214,1959,12,1913,12.37,14970,Peak
1215,1959,13,1651,10.67,16621,Peak
1216,1959,14,2708,17.51,19329,Peak
1217,1959,15,2130,13.77,21459,Peak
1218,1959,17,1781,11.51,23240,Peak
1219,1959,18,1765,11.41,25005,Peak
1220,1959,19,1724,11.15,26729,Peak
1221,1959,20,1525,9.86,28254,Peak
1222,1959,21,1262,8.16,29516,Post_peak
1223,1959,22,1447,9.36,30963,Peak
1224,1959,23,1373,8.88,32336,Peak
1225,1959,24,1202,7.77,33538,Post_peak
1226,1959,25,762,4.93,34300,Post_peak
1227,1959,26,614,3.97,34914,Post_peak
1228,1959,27,572,3.7,35486,Post_peak
1229,1959,28,568,3.67,36054,Post_peak
1230,1959,29,316,2.04,36370,Post_peak
1231,1959,30,334,2.16,36704,Post_peak
1232,1959,31,246,1.59,36950,Receding
1233,1959,33,146,0.94,37096,Receding
1234,1959,34,73,0.47,37169,Receding
1235,1959,36,73,0.47,37242,Receding
1236,1959,37,81,0.52,37323,Receding
1237,1959,38,54,0.35,37377,Receding
1238,1959,39,52,0.34,37429,Receding
1239,1959,40,63,0.41,37492,Receding
1240,1959,41,89,0.58,37581,Receding
1241,1959,42,37,0.24,37618,Receding
1242,1959,43,176,1.14,37794,Receding
1243,1959,44,105,0.68,37899,Receding
1244,1959,45,144,0.93,38043,Receding
1245,1959,46,164,1.06,38207,Receding
1246,1959,47,105,0.68,38312,Receding
1247,1959,48,164,1.06,38476,Receding
1248,1959,49,208,1.34,38684,Receding
1249,1959,50,152,0.98,38836,Receding
1250,1959,51,115,0.74,38951,Receding
1251,1960,1,179,1.13,179,Initial
1252,1960,2,271,1.71,450,Initial
1253,1960,3,243,1.53,693,Initial
1254,1960,4,280,1.76,973,Initial
1255,1960,5,360,2.27,1333,Pre-peak
1256,1960,6,262,1.65,1595,Pre-peak
1257,1960,7,310,1.95,1905,Pre-peak
1258,1960,8,416,2.62,2321,Pre-peak
1259,1960,9,615,3.88,2936,Pre-peak
1260,1960,10,732,4.61,3668,Peak
1261,1960,11,878,5.53,4546,Peak
1262,1960,12,793,5,5339,Peak
1263,1960,13,951,5.99,6290,Peak
1264,1960,14,1342,8.46,7632,Peak
1265,1960,15,903,5.69,8535,Peak
1266,1960,16,817,5.15,9352,Peak
1267,1960,17,1138,7.17,10490,Peak
1268,1960,18,1379,8.69,11869,Peak
1269,1960,19,1099,6.93,12968,Peak
1270,1960,20,1051,6.62,14019,Peak
1271,1960,21,855,5.39,14874,Peak
1272,1960,22,784,4.94,15658,Peak
1273,1960,23,1025,6.46,16683,Peak
1274,1960,24,977,6.16,17660,Peak
1275,1960,25,729,4.59,18389,Peak
1276,1960,26,360,2.27,18749,Post_peak
1277,1960,27,483,3.04,19232,Post_peak
1278,1960,28,307,1.93,19539,Post_peak
1279,1960,29,283,1.78,19822,Post_peak
1280,1960,30,283,1.78,20105,Post_peak
1281,1960,31,176,1.11,20281,Post_peak
1282,1960,32,119,0.75,20400,Receding
1283,1960,33,135,0.85,20535,Receding
1284,1960,34,75,0.47,20610,Receding
1285,1960,35,41,0.26,20651,Receding
1286,1960,36,35,0.22,20686,Receding
1287,1960,37,53,0.33,20739,Receding
1288,1960,38,63,0.4,20802,Receding
1289,1960,39,53,0.33,20855,Receding
1290,1960,40,57,0.36,20912,Receding
1291,1960,41,58,0.37,20970,Receding
1292,1960,42,92,0.58,21062,Receding
1293,1960,43,67,0.42,21129,Receding
1294,1960,44,86,0.54,21215,Receding
1295,1960,45,50,0.32,21265,Receding
1296,1960,46,146,0.92,21411,Post_peak
1297,1960,47,90,0.57,21501,Receding
1298,1960,48,103,0.65,21604,Receding
1299,1960,49,190,1.2,21794,Post_peak
1300,1960,50,117,0.74,21911,Receding
1301,1960,51,179,1.13,22090,Post_peak
1302,1960,52,132,0.83,22222,Receding
1303,1961,1,271,1.64,271,Initial
1304,1961,2,340,2.06,611,Initial
1305,1961,3,452,2.74,1063,Pre-peak
1306,1961,4,755,4.58,1818,Pre-peak
1307,1961,5,568,3.44,2386,Pre-peak
1308,1961,6,757,4.59,3143,Pre-peak
1309,1961,7,742,4.5,3885,Pre-peak
1310,1961,8,640,3.88,4525,Pre-peak
1311,1961,9,836,5.07,5361,Pre-peak
1312,1961,10,1214,7.36,6575,Peak
1313,1961,11,1328,8.05,7903,Peak
1314,1961,12,1308,7.93,9211,Peak
1315,1961,13,1678,10.17,10889,Peak
1316,1961,14,1401,8.49,12290,Peak
1317,1961,16,2276,13.8,14566,Peak
1318,1961,17,1759,10.66,16325,Peak
1319,1961,18,1933,11.72,18258,Peak
1320,1961,19,2227,13.5,20485,Peak
1321,1961,20,1963,11.9,22448,Peak
1322,1961,21,2248,13.63,24696,Peak
1323,1961,22,1677,10.17,26373,Peak
1324,1961,23,2132,12.92,28505,Peak
1325,1961,24,2009,12.18,30514,Peak
1326,1961,25,1186,7.19,31700,Peak
1327,1961,26,756,4.58,32456,Post_peak
1328,1961,27,497,3.01,32953,Post_peak
1329,1961,28,388,2.35,33341,Post_peak
1330,1961,29,398,2.41,33739,Post_peak
1331,1961,30,229,1.39,33968,Post_peak
1332,1961,31,173,1.05,34141,Receding
1333,1961,32,128,0.78,34269,Receding
1334,1961,33,118,0.72,34387,Receding
1335,1961,34,121,0.73,34508,Receding
1336,1961,35,67,0.41,34575,Receding
1337,1961,36,44,0.27,34619,Receding
1338,1961,37,53,0.32,34672,Receding
1339,1961,38,70,0.42,34742,Receding
1340,1961,39,62,0.38,34804,Receding
1341,1961,40,60,0.36,34864,Receding
1342,1961,41,97,0.59,34961,Receding
1343,1961,42,135,0.82,35096,Receding
1344,1961,43,81,0.49,35177,Receding
1345,1961,44,135,0.82,35312,Receding
1346,1961,45,159,0.96,35471,Receding
1347,1961,46,168,1.02,35639,Receding
1348,1961,47,147,0.89,35786,Receding
1349,1961,48,220,1.33,36006,Receding
1350,1961,49,255,1.55,36261,Post_peak
1351,1961,50,316,1.92,36577,Post_peak
1352,1961,51,153,0.93,36730,Receding
1353,1961,52,123,0.75,36853,Receding
1354,1962,1,259,1.52,259,Initial
1355,1962,2,357,2.09,616,Initial
1356,1962,3,351,2.06,967,Initial
1357,1962,4,663,3.88,1630,Pre-peak
1358,1962,5,603,3.53,2233,Pre-peak
1359,1962,6,393,2.3,2626,Pre-peak
1360,1962,7,690,4.04,3316,Pre-peak
1361,1962,8,763,4.47,4079,Pre-peak
1362,1962,9,1116,6.54,5195,Peak
1363,1962,10,1225,7.18,6420,Peak
1364,1962,11,1101,6.45,7521,Peak
1365,1962,12,1326,7.77,8847,Peak
1366,1962,13,1377,8.07,10224,Peak
1367,1962,14,1754,10.27,11978,Peak
1368,1962,15,1488,8.72,13466,Peak
1369,1962,16,1339,7.84,14805,Peak
1370,1962,17,1015,5.95,15820,Peak
1371,1962,18,1443,8.45,17263,Peak
1372,1962,19,1142,6.69,18405,Peak
1373,1962,20,1167,6.84,19572,Peak
1374,1962,21,1011,5.92,20583,Peak
1375,1962,22,929,5.44,21512,Peak
1376,1962,23,952,5.58,22464,Peak
1377,1962,24,955,5.59,23419,Peak
1378,1962,25,609,3.57,24028,Post_peak
1379,1962,26,446,2.61,24474,Post_peak
1380,1962,27,384,2.25,24858,Post_peak
1381,1962,28,305,1.79,25163,Post_peak
1382,1962,29,237,1.39,25400,Post_peak
1383,1962,30,234,1.37,25634,Post_peak
1384,1962,31,148,0.87,25782,Receding
1385,1962,32,167,0.98,25949,Receding
1386,1962,33,115,0.67,26064,Receding
1387,1962,34,83,0.49,26147,Receding
1388,1962,35,61,0.36,26208,Receding
1389,1962,36,38,0.22,26246,Receding
1390,1962,37,45,0.26,26291,Receding
1391,1962,38,58,0.34,26349,Receding
1392,1962,39,76,0.45,26425,Receding
1393,1962,40,56,0.33,26481,Receding
1394,1962,41,74,0.43,26555,Receding
1395,1962,42,68,0.4,26623,Receding
1396,1962,43,102,0.6,26725,Receding
1397,1962,44,91,0.53,26816,Receding
1398,1962,45,78,0.46,26894,Receding
1399,1962,46,136,0.8,27030,Receding
1400,1962,47,161,0.94,27191,Receding
1401,1962,48,136,0.8,27327,Receding
1402,1962,49,181,1.06,27508,Post_peak
1403,1962,50,220,1.29,27728,Post_peak
1404,1962,51,163,0.95,27891,Receding
1405,1962,52,249,1.46,28140,Post_peak
1406,1964,1,167,0.92,167,Initial
1407,1964,2,305,1.68,472,Initial
1408,1964,3,401,2.21,873,Initial
1409,1964,4,544,3,1417,Pre-peak
1410,1964,5,604,3.33,2021,Pre-peak
1411,1964,6,501,2.76,2522,Pre-peak
1412,1964,7,479,2.64,3001,Pre-peak
1413,1964,8,623,3.43,3624,Pre-peak
1414,1964,9,727,4.01,4351,Pre-peak
1415,1964,10,889,4.9,5240,Pre-peak
1416,1964,11,1358,7.48,6598,Peak
1417,1964,12,1407,7.75,8005,Peak
1418,1964,13,1166,6.42,9171,Pre-peak
1419,1964,14,1111,6.12,10282,Pre-peak
1420,1964,15,2340,12.89,12622,Peak
1421,1964,16,1507,8.3,14129,Peak
1422,1964,17,1886,10.39,16015,Peak
1423,1964,19,2059,11.34,18074,Peak
1424,1964,20,1983,10.93,20057,Peak
1425,1964,21,2025,11.16,22082,Peak
1426,1964,22,1849,10.19,23931,Peak
1427,1964,23,1571,8.66,25502,Peak
1428,1964,24,1545,8.51,27047,Peak
1429,1964,25,1244,6.85,28291,Peak
1430,1964,26,852,4.69,29143,Post_peak
1431,1964,27,465,2.56,29608,Post_peak
1432,1964,28,453,2.5,30061,Post_peak
1433,1964,29,234,1.29,30295,
1434,1964,30,230,1.27,30525,Receding
1435,1964,31,207,1.14,30732,Receding
1436,1964,32,142,0.78,30874,Receding
1437,1964,33,135,0.74,31009,Receding
1438,1964,34,97,0.53,31106,Receding
1439,1964,35,101,0.56,31207,Receding
1440,1964,36,31,0.17,31238,Receding
1441,1964,37,30,0.17,31268,Receding
1442,1964,38,64,0.35,31332,Receding
1443,1964,39,37,0.2,31369,Receding
1444,1964,40,58,0.32,31427,Receding
1445,1964,41,61,0.34,31488,Receding
1446,1964,42,92,0.51,31580,Receding
1447,1964,43,76,0.42,31656,Receding
1448,1964,44,76,0.42,31732,Receding
1449,1964,45,80,0.44,31812,Receding
1450,1964,46,105,0.58,31917,Receding
1451,1964,47,97,0.53,32014,Receding
1452,1964,48,94,0.52,32108,Receding
1453,1964,49,107,0.59,32215,Receding
1454,1964,50,159,0.88,32374,Receding
1455,1964,51,128,0.71,32502,Receding
1456,1964,52,148,0.82,32650,Receding
